11111111111111111111111111111111111111111111111111111111111111111111111111111111111111111111111111111111111111
11E0000111E0000111E0000111E0000111E0000111E0000111E0000111E0000111E0000111E0000111E0000111E0000111E0000111E001
10100E1110100E1110100E1110100E1110100E1110100E1110100E1110100E1110100E1110100E1110100E1110100E1110100E11101001
11000C0111000C0111000C0111000C0111000C0111000C0111000C0111000C0111000C0111000C01110P0C0111000C0111000C01110001
100V0001100V0001100V000110010001110010001110010001110010001110010001110010001110010001110010001110010001110011
10000V0110000V0110000V0110000V0110000V0110000V0110000V0110000V0110000V0110000V0110000V0110000V0110000V01100001
11111111111111111111111111111111111111111111111111111111111111111111111111111111111111111111111111111111111111





