1111111111
1E00V01101
11C0000P01
10011C01V1
10011110C1
1000101011
111V000101
11100000V1
1C00110CE1
1111111111